####################
#.....i...#..l.....#
#.@...z...#.....z..#
#..#..##..#..#...#.#
#..#......d....s...#
#...f..#..#...f..#.#
#.z....#..#.z.#....#
#..#####..#.....#..#
#....h....#........#
####d###############
#........#.....#
#..............#
#..........#...#
#..#..#........#
#..#...#....g..#
#......#....#..#
#.z............#
#.....##.......#
#....h.........#
################