##########
#.....o..#
#........#
#.....g..#
#..g.....#
#........#
#...s....#
#........#
#........#
##########